###########################################
#                                         #
#                                         #
#                    #                    #
#                    #                    #
#                    #                    #
#                    #########            #
#                                         #
#                                         #
#          #                              #
#          #                              #
#          #                              #
#          #               ###            #
#                          ###            #
#                          ###            #
#                                         #
###########################################